###############
#.............#
#..P....A.....#
#.............#
#.....B.......#
#.............#
#........C....#
#.............#
###############