##############################
#      FOOTBALL  GROUND      #
#   o                    o   #
#   +====================+   #
#   |  o            o    | B #
#   |    [GOAL]         |    #
#   |                    |   #
# P |        @@          | o #
#   |        @@          |   #
#   |                    |   #
#   |    [GOAL]     o    |   #
#   |  o            A    |   #
#   +====================+   #
#   o                    o   #
#                          D #
##############################
