##############################
#         POOL  AREA         #
#   o                    o   #
#     ##################     #
#     #~~~~~~~~~~~~~~#     B #
#     #~~~~~~~~~~~~~~#       #
#  A  #~~~~~~~~~~~~~~#   o   #
#     #~~~~~~~~~~~~~~#       #
#     #~~~~~~~~~~~~~~#       #
#     ##################     #
#   o      P             C   #
#      ======  ======    o   #
#      BENCH   BENCH         #
#   o                        #
#                          D #
##############################
