##############################
#       CLASSROOM  101       #
#  A +-----+ +-----+ +-----+ #
#    |DESK | |DESK | |DESK | #
#    +--o--+ +--o--+ +--o--+ #
#                            #
#    +-----+ +-----+ +-----+ #
#    |DESK | |DESK | |DESK | #
#    +-----+ +-----+ +-----+ #
#            P           B   #
#    +-----+ +-----+ +-----+ #
#    |DESK | |DESK | |DESK | #
#    +--o--+ +--o--+ +--o--+ #
#                        C   #
#     ###BLACKBOARD###     D #
##############################
