##############################
#        SCHOOL  YARD        #
#   o  ####    ####    o     #
#      #  #    #  #      B   #
#   P  #  # A  #  #          #
#      ####    ####      o   #
#                            #
#      ~~FOUNTAIN~~          #
#      ~~       ~~       C   #
#      ~~FOUNTAIN~~          #
#                            #
#   o   TREE    TREE     o   #
#       TREE    TREE         #
#   o                    o   #
#                          D #
##############################
